 E
   __________________________________________________________________
|*  |     |           |         |       |         |     |           |
|*| | |_| |___|___|___| |___|___| |___|_| |___|___| | |_| |___|___|_| 
|*|   |   |       |   |     |   |   | | |   |   | | |   |       | | |
|*|___|_| |___|___| | |___| | |_|_| | | | | | | | | | |___|___|___| | 
|*****| |         | |     | |     | |   | | | | | |   |           | | 
|___|*| |___|___|_| |___| |_|___|_| |___|_| | | | |___|___|___|___| | 
|   |***********| |     |       | |       |   | |             |   | |
| | |___|___|___|*|___| |___|___| |___|___|___| |___|___|___|___| |_| 
| |         |   |*****|     |   |         |   |             |   |   |
| |___|___|_| | |___| |*__|_| | |___|___| | | |___|___|___|___| | |_| 
|       |   | |     |*****| | |       | | | |           |     | |   |
|___|___| | | |___| |___|*| | |___|___| | | |___|___|___| |___| | |_| 
|     | | | |   | |     |*| |       | | |             | |   | |   | |
| |___| | | | | | |___| |*| |___|___| | |___|___|___|___| | | | |_| | 
| |   | | |   | |     | |*|         | |               | | | |   | | |
| | | | | |___|_|___| | |*|___|___|_| |___|___|___|___| | | |___| | | 
| | | |   |         | | |*********|               |   | | |     | | |
| | | |___|___|___|_| | |___|___|*| |___|___|___|___|_| |_| | |___| | 
| | |             | |         | |*|             | |   | |     | | | |
| | |___|___|___|_| |___|___|_| | |*|___|___|___| | |_| |___| | | | | 
| |           |   |         | | | |***********| | |   |   | | | | | |
| |___|___|___| | |___|___| | | | |___|___|___|*| | |_| | | | | | | | 
|         |   | |       | | | | |           | |*| |   | | | | | | | |
|___|___|_| |_| |___|___| | | | |___|___|___| | |*| |_| | | | | | | | 
|       | |   |       | | | |             | | | |*|   | | | | | | | |
| |___|_| | |_|___|___| | | |___|___|___|___| | | |*| |_| | | | | | | 
| |     | |           | | |               | | | | |*|   | | | | | | |
| | |___| |___|___|___| | |___|___|___|___| | | | | |*|_| | | | | | | 
| | |   |           | | |               | | | | | | |***| | | | | | |
| | | | |___|___|___| | |___|___|___|___| | | | | | | |_|*| | | | | | 
| | | |           | | |               | | | | | | | |   |*| | | | | |
| | | |___|___|___| | |___|___|___|___| | | | | | | | |_| |*| | | | | 
| | |           | | |               | | | | | | | | |   | |*| | | | |
| | |___|___|___| | |___|___|___|___| | | | | | | | | |_| | |*| | | | 
| |           | | |               | | | | | | | | | |   | | |*| | | |
| |___|___|___| | |___|___|___|___| | | | | | | | | | |_| | | |*| | | 
|           | | |               | |_| | | | | | | | |   | | | |*| | |
|___|___|___| | |___|___|___|___| | | | | | | | | | | |_| | | | |*| | 
|         | | |               | | | |_| | | | | | | |   | | | | |*| |
| |___|___| | |___|___|___|___| | | | | | | | | | | | |_| | | | | |*| 
| |       | |               | | | |_| | | | | | | | |   | | | | | |*|
| | |___|_| |___|___|___|___| | | | | | | | | | | | | |_| | | | | |*|
| | |     |               | | | | | | | | | | | | | |   | | | | | |*|
| | | |___|___|___|___|___| | | | | | | | | | | | | | |_| | | | | |*|
| | | |                 | | | | | | | | | | | | | | |   | | | | | |*|
| | | |___|___|___|___|___| | | | | | | | | | | | | | |_| | | | | |*|
| | |                   | | | | | | | | | | | | | | |   | | | | | |*|
| | |___|___|___|___|___| | | | | | | | | | | | | | | |_| | | | | |*|
| |                   | | | | | | | | | | | | | | | |   | | | | | |*|
| |___|___|___|___|___| | | | | | | | | | | | | | | | |_| | | | | |*|
|                   | | | | | | | | | | | | | | | | |   | | | | | |*|
|___|___|___|___|___| | | | | | | | | | | | | | | | | |_| | | | | |*|
|                 | | | | | | | | | | | | | | | | | |   | | | | | |*|
| |___|___|___|___| | | | | | | | | | | | | | | | | | |_| | | | | |*|
| |             | | | | | | | | | | | | | | | | | | |   | | | | | |*|
| | |___|___|___| | | | | | | | | | | | | | | | | | | |_| | | | | |*|
| | |         | | | | | | | | | | | | | | | | | | | |   | | | | | |*|
| | | | | | |___|_| | | | | | | | | | | | | | | | | | |_| | | |    *|
| | | | | |         | | | | | | | | | | | | | | | | |   | | |___|_|*|
| | | | | |___|___|_| | | | | | | | | | | | | | | | | |_| |        *|
| | | | |             | | | | | | | | | | | | | | | |   | |___|___|*|
| | | | |___|___|___|_| | | | | | | | | | | | | | | | |_|        ***|
| | | |               | | | | | | | | | | | | | | | |   |___|___|*__|
| | | |___|___|___|___| | | | | | | | | | | | | | | | |_|      ***|_|
| | |                 | | | | | | | | | | | | | | |   |___|___|* _|_|
| | |___|___|___|___|_| | | | | | | | | | | | | | | |_|        *****|
| |                   | | | | | | | | | | | | | |   |___|___|___|  *|
|_|___|___|___|___|___|_|_|_|_|_|_|_|_|_|_|_|_|_|_|_______________|*    S   